3 0 0 0 0 13 0 0 10 46 0 
0 0 67 0 0 0 0 0 0 3 0 
0 0 0 0 0 0 0 0 46 0 48 
9 48 38 0 22 3 23 0 50 0 45 
0 0 45 0 38 45 38 0 0 0 0 
0 0 0 0 0 0 0 0 0 0 0 
0 0 0 0 0 4 0 0 0 0 50 
59 0 0 0 0 0 0 0 0 0 16 
0 0 0 0 0 0 0 0 24 0 0 
0 0 0 0 0 0 0 0 0 0 0 
0 50 0 0 16 38 0 0 0 13 0 
