13 0 34 0 0 3 0 3 0 0 0 
0 0 0 0 0 50 0 0 0 13 0 
0 0 0 0 38 0 0 45 0 0 0 
61 62 0 0 0 13 0 48 0 0 0 
0 0 0 0 0 0 0 45 0 10 8 
0 59 67 38 0 0 0 0 0 48 59 
24 24 0 56 38 9 0 0 0 56 38 
0 0 0 0 4 0 0 0 0 24 25 
0 40 0 0 69 24 0 0 0 0 0 
0 0 0 0 0 0 0 0 0 0 0 
0 0 0 33 33 74 0 50 38 50 0 
