0 23 22 0 0 3 0 18 0 0 13 
0 0 3 0 0 0 0 0 0 0 0 
0 0 0 0 0 0 0 0 60 0 0 
60 44 60 0 44 44 0 0 0 0 4 
0 0 0 0 44 44 0 25 0 37 56 
0 0 0 0 0 0 0 0 0 0 37 
0 0 0 4 0 0 0 4 0 0 0 
0 0 4 0 0 0 0 60 19 20 21 
0 44 44 44 0 4 4 56 0 0 9 
0 0 0 0 0 56 0 60 0 0 10 
23 22 24 10 0 10 0 0 0 0 0 
