0 0 0 53 22 0 0 0 0 0 0 
0 3 0 0 0 0 0 0 40 53 0 
0 0 0 0 0 40 0 33 0 24 9 
0 0 0 0 0 0 0 0 0 61 62 
0 45 0 0 0 0 0 5 0 0 0 
0 0 0 45 0 0 0 56 0 0 0 
0 0 0 5 0 0 0 0 0 0 0 
0 0 33 0 0 0 0 52 0 0 0 
0 0 0 37 0 0 0 25 0 0 59 
0 0 0 0 0 0 0 0 0 0 0 
70 29 0 0 52 0 53 10 0 0 13 
