1 1 1 1 1 94 1 1 1 1 1 
1 1 1 1 1 94 1 1 1 1 1 
1 1 94 1 1 1 1 1 94 1 1 
1 1 1 94 1 1 1 94 1 1 1 
1 1 1 1 94 1 94 1 1 1 1 
94 94 94 1 1 1 1 1 94 94 94 
1 1 1 1 94 1 94 1 1 1 1 
1 1 1 94 1 1 1 94 1 1 1 
1 1 94 1 1 1 1 1 94 1 1 
1 1 1 1 1 94 1 1 1 1 1 
1 1 1 1 1 94 1 1 1 1 1 
