1 73 1 73 73 1 73 73 1 1 1 
1 73 1 73 1 1 1 73 1 1 1 
1 73 1 73 1 1 1 73 1 1 1 
1 73 1 73 1 1 1 73 73 1 73 
1 1 1 73 73 1 73 73 1 1 73 
1 73 1 1 73 1 73 1 1 1 73 
1 73 1 1 73 1 73 1 1 1 73 
1 73 1 1 1 1 1 1 1 1 73 
1 73 1 1 73 1 73 1 1 1 73 
1 73 1 73 73 1 73 1 1 73 73 
1 73 73 73 73 1 73 1 1 1 73 
