25 0 9 0 0 3 0 0 18 8 22 
23 0 10 0 0 24 0 0 0 0 0 
0 0 10 0 38 4 4 0 38 48 38 
16 0 0 0 0 38 38 0 0 4 0 
0 5 0 0 0 0 0 0 50 59 0 
0 0 0 0 0 6 0 0 0 50 0 
48 0 0 0 0 45 0 0 0 0 0 
0 0 50 0 0 0 4 0 0 0 0 
16 0 59 50 0 0 0 0 0 0 0 
0 0 10 0 0 0 0 0 0 0 0 
24 0 0 0 0 13 0 0 22 3 0 
