0 0 47 0 0 13 0 0 47 0 0 
0 0 0 0 0 0 0 0 0 0 0 
0 0 24 23 0 45 67 47 10 0 0 
0 0 0 45 0 0 0 0 61 0 0 
47 0 0 67 0 6 0 0 0 0 47 
46 0 0 0 0 40 0 0 0 0 46 
47 0 0 0 0 4 0 0 0 0 47 
0 0 0 45 67 46 0 8 62 0 0 
0 0 25 22 0 0 0 45 0 0 0 
0 0 0 0 0 0 0 67 0 0 0 
0 0 45 0 0 3 0 0 45 0 0 
