1 77 1 77 77 1 77 77 1 77 1 
77 1 77 1 77 1 77 1 77 1 77 
1 77 1 77 77 1 77 77 1 77 1 
77 1 77 1 77 1 77 1 77 1 77 
1 77 1 77 77 1 77 77 1 77 1 
77 1 77 1 77 1 77 1 77 1 77 
1 77 1 77 77 1 77 77 1 77 1 
77 1 77 1 77 1 77 1 77 1 77 
1 77 1 77 77 1 77 77 1 77 1 
77 1 77 1 77 1 77 1 77 1 77 
1 77 1 77 73 1 73 77 1 77 1 
