25 00 9 00 00 3 00 00 18 8 22 
23 00 10 00 83 84 85 00 00 00 00 
00 00 10 00 86 87 88 00 38 48 38 
16 00 00 00 89 90 91 00 00 4 00 
00 5 00 00 00 00 00 00 50 59 00 
00 00 00 00 00 6 00 00 00 50 00 
48 00 00 00 00 45 00 00 00 00 00 
00 00 50 00 00 00 4 00 00 00 00 
16 00 59 50 00 00 00 00 00 00 00 
00 00 10 00 00 00 00 00 00 00 00 
24 00 00 00 00 13 00 00 22 3 00 
