22 0 0 0 0 3 0 0 0 0 23 
24 59 0 0 0 26 59 59 0 59 24 
10 0 0 59 59 67 0 0 0 0 10 
0 0 0 0 0 67 0 0 0 0 0 
0 0 0 0 0 0 0 0 0 0 0 
0 0 0 0 0 0 0 0 0 0 0 
26 0 26 0 0 0 0 26 15 0 0 
67 0 67 0 0 67 0 0 67 0 67 
59 0 59 0 0 15 0 0 59 59 59 
0 0 0 0 0 0 0 0 0 59 0 
10 9 10 0 0 13 0 0 0 8 0 
