10 10 0 29 3 0 0 22 22 23 23 
10 10 0 0 0 37 0 24 24 24 9 
0 39 0 0 0 37 0 61 0 0 0 
18 0 39 62 0 0 0 0 0 72 0 
0 5 0 0 0 0 0 0 42 0 42 
0 0 43 0 33 0 33 0 0 0 0 
0 43 0 0 0 4 0 0 0 43 0 
0 43 0 10 0 4 0 10 0 4 4 
0 0 0 0 53 52 53 0 0 0 4 
5 0 0 0 0 0 0 0 0 0 43 
40 0 40 0 13 0 3 0 40 0 0 
