0 55 0 0 0 51 26 0 0 16 10 
0 34 0 0 4 0 0 0 0 0 0 
0 27 0 0 0 0 0 0 0 0 16 
0 0 0 22 0 0 0 23 0 0 49 
0 0 0 22 0 48 0 23 0 0 0 
13 0 0 10 5 53 5 10 0 0 3 
0 0 0 25 0 48 0 24 0 0 0 
0 0 0 25 0 0 0 24 0 29 25 
26 26 0 0 0 4 0 0 0 22 23 
0 0 0 51 0 0 0 47 0 46 46 
0 0 0 51 0 0 0 47 0 0 0 
