102 67 100 0 0 114 0 0 100 67 102 
0 0 64 0 0 72 0 0 0 0 0 
13 0 0 0 36 101 36 19 0 21 13 
39 0 0 64 29 66 0 0 0 0 39 
0 64 0 66 10 0 9 0 0 0 0 
0 54 0 0 0 32 19 0 21 54 0 
0 19 0 21 9 0 10 0 0 0 0 
39 0 64 18 66 0 0 64 0 66 39 
13 0 0 0 0 3 0 0 0 0 13 
0 0 0 0 0 0 19 0 21 0 0 
102 67 36 0 0 0 0 0 36 67 102 
