62 0 0 23 0 0 61 0 0 0 0 
0 39 0 0 0 39 0 0 0 0 0 
0 67 0 0 0 67 0 0 40 0 0 
0 53 0 0 0 53 0 0 0 0 40 
0 0 0 0 0 0 0 0 0 0 40 
25 0 24 0 9 0 10 0 39 0 40 
0 4 0 0 0 4 0 0 0 0 40 
0 32 0 0 0 42 0 0 40 0 0 
0 6 0 0 0 6 0 0 0 0 0 
12 0 0 0 0 42 0 0 39 0 0 
23 0 18 0 22 0 29 0 13 0 3 
