0 0 13 0 10 10 0 0 0 0 0 
0 55 6 0 10 49 0 0 0 0 0 
10 0 0 0 0 4 0 55 0 26 0 
0 17 34 0 0 9 0 4 0 34 0 
0 46 0 10 0 0 0 0 0 0 0 
3 0 0 0 0 0 0 46 0 0 0 
0 17 47 0 4 15 0 24 0 0 0 
0 24 0 24 0 15 0 25 0 17 0 
0 0 0 0 0 0 0 0 0 0 0 
0 64 65 66 0 0 0 0 0 4 0 
0 23 0 22 5 17 0 13 0 0 0 
