37 0 37 37 13 0 3 0 0 43 43 
0 0 0 0 0 0 0 0 0 0 0 
0 0 9 8 0 12 0 24 24 0 0 
0 0 10 10 0 6 0 24 24 0 40 
33 0 0 53 5 42 5 53 0 0 0 
33 0 4 0 0 0 0 0 4 0 0 
0 0 22 0 38 38 18 0 23 0 0 
0 0 22 0 0 4 4 0 23 0 0 
0 0 22 0 0 16 0 0 23 0 0 
0 0 0 0 0 6 0 0 0 0 0 
52 52 0 0 43 0 0 0 0 0 52 
