23 0 0 0 0 0 0 3 0 0 23 
0 22 0 36 0 0 36 100 36 0 0 
0 54 5 100 0 0 100 36 100 0 0 
0 23 0 36 0 0 0 0 0 0 0 
0 0 0 0 0 0 0 4 0 0 0 
10 10 100 36 0 0 0 36 100 10 10 
0 0 0 4 0 0 0 0 0 0 0 
0 8 105 54 105 8 0 102 0 25 0 
0 8 105 54 105 8 0 103 5 76 0 
0 8 105 54 105 8 0 102 0 25 0 
22 0 0 13 0 0 0 0 0 0 23 
