69 32 32 0 0 0 0 0 39 39 0 
32 0 0 0 0 0 0 0 0 0 0 
32 0 10 9 10 0 0 0 22 0 39 
0 0 100 100 100 0 36 0 23 0 39 
3 0 0 0 0 4 36 4 9 0 13 
0 0 0 0 0 0 0 0 0 0 0 
18 39 0 0 0 23 22 0 0 0 0 
0 0 40 0 0 0 0 0 0 0 32 
0 0 40 0 0 0 36 0 0 0 32 
40 0 0 0 39 0 32 0 0 0 0 
0 0 3 0 0 0 24 0 13 0 25 
