1 1 1 1 0 1 0 1 1 1 1 
1 1 1 1 0 1 0 1 1 1 1 
1 1 1 1 0 1 0 1 1 1 1 
1 1 77 1 1 1 1 1 77 1 1 
1 77 73 77 1 1 1 77 73 77 1 
77 77 77 77 77 1 77 77 77 77 77 
1 1 1 1 1 1 1 1 1 1 1 
1 73 73 73 73 73 73 73 73 73 1 
1 73 73 73 73 73 73 73 73 73 1 
1 1 1 1 1 1 1 1 1 1 1 
73 73 73 73 1 0 1 73 73 73 73 
