0 0 0 0 0 0 0 27 0 55 24 
0 0 0 0 49 0 0 46 27 0 0 
25 10 0 0 0 51 0 0 0 0 0 
10 38 0 16 0 51 0 26 0 0 0 
38 16 5 26 0 51 0 26 0 0 0 
0 0 0 26 0 0 0 0 0 0 13 
0 3 0 0 0 22 0 23 0 0 0 
24 24 0 0 0 10 0 10 0 3 0 
26 26 0 4 0 38 0 38 0 0 0 
0 0 46 47 46 0 34 0 0 0 0 
0 0 0 0 0 0 0 0 4 16 0 
