2 2 94 1 1 1 1 1 94 2 2 
2 2 94 94 94 1 94 94 94 2 2 
2 2 94 94 94 1 94 94 94 2 2 
2 2 94 1 1 1 1 1 94 2 2 
2 2 94 94 1 1 1 94 94 2 2 
2 2 94 94 94 1 94 94 94 2 2 
2 2 94 94 1 1 1 94 94 2 2 
2 2 94 94 94 1 94 94 94 2 2 
2 2 94 94 94 1 94 94 94 2 2 
2 2 94 94 94 1 94 94 94 2 2 
2 2 94 94 94 94 94 94 94 2 2 
