0 0 0 8 8 0 8 8 0 0 0 
0 0 0 0 0 0 0 0 0 0 0 
0 0 0 0 0 0 0 0 0 0 0 
0 0 0 25 0 0 0 25 0 0 0 
0 0 0 0 23 0 22 0 0 0 0 
0 0 0 0 0 6 0 0 0 0 0 
0 0 0 0 8 58 8 0 0 0 0 
0 0 0 0 0 0 0 0 0 0 0 
0 0 0 0 0 6 0 0 0 0 0 
0 0 0 0 0 78 0 0 0 0 0 
0 0 0 0 0 0 0 0 0 0 0 
