13 0 22 0 24 0 24 0 10 0 3 
52 0 0 0 44 0 43 0 43 0 0 
0 52 0 0 0 0 0 0 0 0 0 
0 0 4 0 0 0 0 0 4 4 37 
0 0 10 0 0 0 0 0 0 0 0 
0 0 0 0 10 0 37 0 0 4 60 
0 4 0 0 4 4 4 0 0 0 0 
0 0 0 0 33 0 10 0 0 0 0 
0 0 0 0 0 0 0 0 0 0 0 
52 0 33 4 0 0 43 0 0 0 0 
23 0 0 0 0 0 9 0 33 0 0 
