40 8 0 23 0 0 22 69 23 0 13 
4 0 0 0 0 0 0 0 0 0 0 
0 0 0 43 24 0 0 72 0 0 0 
0 0 0 0 0 0 39 0 39 0 40 
0 0 0 34 10 0 0 0 0 0 0 
0 5 0 4 0 0 0 0 0 0 43 
0 43 0 43 0 0 24 10 0 0 0 
0 4 0 4 0 0 53 52 4 4 0 
0 33 0 33 24 0 24 10 0 0 0 
0 0 0 0 0 0 0 0 0 0 52 
13 0 40 0 3 0 3 0 0 52 0 
