3 0 0 0 0 13 0 0 0 0 0 
67 0 0 0 0 0 0 0 0 0 0 
54 0 0 0 0 0 0 0 0 0 0 
54 0 0 0 0 0 0 0 0 0 0 
54 0 0 0 0 0 0 0 0 0 0 
0 28 104 104 105 105 103 103 67 41 63 
54 0 0 0 0 0 0 0 0 0 0 
54 0 0 0 0 0 0 0 0 0 0 
101 0 0 0 0 0 0 0 0 0 0 
67 0 0 0 0 0 0 0 0 0 0 
63 0 0 0 0 63 0 0 0 0 0 
