9 10 43 0 0 13 0 0 10 43 0 
0 0 0 44 0 44 0 0 0 0 44 
0 0 0 0 0 67 0 0 0 0 0 
0 0 0 67 0 44 0 0 67 0 0 
0 0 0 0 0 22 0 0 0 0 0 
0 67 0 0 0 0 0 0 0 67 0 
24 0 0 10 0 0 0 10 0 0 25 
0 0 67 0 0 23 0 0 67 0 0 
0 0 0 0 0 67 0 0 0 0 0 
0 0 0 0 0 43 0 0 0 0 0 
0 0 67 0 0 3 0 0 67 0 0 
