95 1 1 94 1 1 94 1 94 95 1 
1 95 1 94 95 1 94 1 94 95 1 
1 1 1 94 1 1 94 1 94 1 1 
1 95 1 94 1 95 1 1 94 1 1 
94 94 94 94 1 94 94 94 94 94 94 
1 1 95 1 1 1 1 94 94 1 1 
94 94 94 94 94 94 1 1 95 95 1 
95 1 1 1 1 94 1 94 94 94 94 
1 1 1 1 94 94 1 1 95 1 1 
1 1 95 94 1 94 1 94 94 1 1 
1 94 94 94 1 94 1 1 94 1 1 
