00 00 00 00 00 00 00 00 00 00 00
00 22 23 00 00 57 00 13 00 00 00
00 24 24 00 00 00 00 00 00 00 00
00 00 48 00 59 00 00 00 14 00 00
00 00 06 00 00 00 00 00 00 00 00
00 00 38 00 06 00 09 00 00 00 00
00 04 00 04 00 00 00 12 00 15 00
00 00 00 22 00 00 00 12 00 15 00
00 08 00 23 00 10 00 00 00 25 00
00 08 00 00 09 18 00 03 00 03 00
00 00 00 00 00 00 00 00 00 00 00