13 0 0 0 29 0 0 0 0 0 0 
0 0 0 0 0 0 0 0 0 0 0 
0 0 0 0 0 0 0 0 13 0 0 
0 0 0 0 0 0 0 0 0 0 0 
0 0 0 0 0 0 0 0 0 0 0 
0 0 0 0 0 0 0 0 0 0 0 
0 0 0 0 0 0 0 0 0 0 0 
0 5 0 0 0 0 0 0 0 5 0 
45 48 45 0 0 0 0 0 59 38 59 
22 45 22 0 56 0 56 0 23 59 23 
25 76 25 0 3 0 3 0 24 8 24 
