77 77 77 77 77 01 77 77 77 77 77 
77 01 01 01 77 01 77 01 01 01 77 
77 77 77 77 77 01 77 77 77 77 77 
77 01 01 77 01 01 01 77 01 01 77 
77 01 01 77 01 01 01 77 01 01 77 
77 77 77 77 01 01 01 77 77 77 77 
77 01 01 77 77 01 77 77 01 01 77 
77 01 77 01 77 01 77 01 77 01 77 
77 01 77 01 77 01 77 01 77 01 77 
77 01 77 01 77 01 77 01 77 01 77 
77 01 77 01 73 01 73 01 77 01 77 
