0 0 0 0 0 36 36 36 0 0 0 
0 0 0 0 0 0 32 0 0 0 0 
0 0 98 0 24 0 4 0 10 0 99 
0 0 6 0 24 0 4 0 10 0 6 
13 0 6 6 24 5 32 5 10 6 6 
0 0 0 0 0 0 0 0 0 0 0 
0 53 53 53 0 0 0 0 0 0 10 
0 0 0 0 42 0 0 0 39 0 0 
0 0 0 0 0 0 0 0 39 0 0 
42 0 0 0 42 0 40 0 0 0 40 
23 0 13 0 22 0 0 0 3 0 0 
