22 0 0 0 0 3 0 0 0 0 23 
50 0 0 0 0 0 0 0 0 0 50 
0 0 0 0 0 50 0 0 0 0 0 
0 0 0 0 0 0 0 0 0 0 0 
6 0 0 0 0 6 0 0 0 0 6 
27 0 0 0 0 27 0 0 0 0 27 
0 0 14 14 0 0 0 0 14 14 0 
0 0 0 0 0 4 0 0 0 0 0 
0 0 0 0 0 12 0 0 0 0 0 
0 0 0 0 0 0 0 0 0 0 0 
0 0 0 0 0 0 0 0 0 0 0 
