106 0 0 0 0 107 0 0 0 0 108 
0 0 0 0 0 0 0 0 0 0 0 
0 0 0 0 0 0 0 0 0 0 0 
0 0 0 0 0 0 0 0 0 0 0 
6 0 0 0 0 6 0 0 0 0 6 
0 0 0 0 0 5 0 0 0 0 0 
0 0 0 0 5 4 5 0 0 0 0 
0 0 0 0 0 4 0 0 0 0 0 
0 0 0 0 0 4 0 0 0 0 0 
0 0 0 0 0 0 0 0 0 0 0 
29 0 0 0 0 13 0 0 0 0 8 
