23 0 0 0 0 114 0 0 0 0 63 
69 0 0 0 0 69 0 0 0 0 69 
69 0 0 0 0 69 0 0 0 0 69 
0 0 0 0 0 101 0 0 0 0 0 
5 0 0 0 0 5 0 0 0 0 5 
0 0 0 0 0 0 0 0 0 0 0 
5 0 0 0 0 4 0 0 0 0 5 
0 0 0 0 0 0 0 0 0 0 0 
0 0 0 0 0 0 0 0 0 0 0 
0 5 5 0 0 0 0 0 0 0 0 
0 0 0 22 0 0 0 30 0 0 0 
