0 0 49 0 13 0 46 51 46 0 13 
0 0 26 0 0 0 0 0 0 0 0 
0 0 0 0 51 0 0 0 0 0 0 
63 0 6 0 34 0 0 49 16 0 46 
22 0 56 0 0 0 0 16 0 0 0 
23 0 0 0 6 0 0 4 0 0 0 
68 0 48 0 0 0 0 4 0 0 38 
24 0 45 0 0 0 0 4 0 0 5 
25 0 45 0 0 0 0 69 0 0 5 
33 0 0 0 26 3 38 55 38 0 0 
0 0 0 0 0 0 0 0 0 0 0 
