29 0 0 22 0 0 13 0 0 0 23 
0 0 0 0 0 0 42 0 0 0 23 
52 0 5 0 0 0 0 4 33 5 53 
10 33 0 0 0 4 55 0 0 0 0 
0 0 0 0 0 0 0 0 0 0 8 
24 37 37 0 0 0 0 0 0 4 5 
0 0 0 0 0 0 0 0 0 0 4 
0 52 0 0 40 0 3 0 0 52 0 
0 4 0 0 0 0 0 0 0 4 0 
43 0 0 0 0 0 0 0 0 52 24 
24 0 0 0 43 4 40 4 52 24 10 
