14 0 3 0 0 13 0 47 0 0 0 
0 16 0 0 0 0 0 0 0 0 0 
8 49 0 0 0 0 0 0 0 17 0 
0 0 0 4 0 9 0 0 0 0 0 
0 26 0 0 0 10 0 27 0 0 15 
0 0 0 0 0 0 0 0 0 4 0 
0 34 4 0 0 25 0 0 0 0 0 
0 0 0 0 0 22 0 0 0 0 0 
0 0 0 0 0 0 15 0 0 0 47 
0 46 0 0 0 0 0 0 0 0 0 
0 22 0 0 27 0 0 3 0 0 24 
