00 00 00 00 00 00 00 00 00 00 00
00 03 00 15 00 00 00 00 05 00 00
00 00 00 00 00 14 00 00 00 00 00
00 15 00 00 14 15 00 00 00 00 00
00 00 00 00 00 00 00 00 00 00 00
03 00 00 00 15 00 00 05 00 00 00
00 00 00 00 00 00 00 00 00 04 00
00 00 00 00 00 00 00 00 00 00 00
00 03 12 14 00 00 14 00 00 00 00
00 00 00 00 00 00 00 13 00 13 00
00 00 00 00 00 00 00 00 00 00 00