00 00 00 00 00 00 00 00 00 00 00
00 29 12 00 00 13 00 03 00 00 00
00 00 14 00 00 00 00 00 15 00 00
00 00 00 00 00 00 00 12 14 12 00
00 15 00 00 00 00 15 00 00 00 00
00 00 00 00 00 00 00 00 00 00 00
00 00 05 00 00 00 04 00 00 17 00
00 12 00 12 00 00 00 00 00 04 00
00 24 16 24 00 00 00 18 00 00 00
00 22 10 23 00 12 00 08 10 10 00
00 00 00 00 00 00 00 00 00 00 00