37 0 37 37 13 0 3 0 0 43 43 
0 0 0 0 0 0 0 0 0 0 0 
0 0 9 8 0 124 0 24 24 0 0 
0 0 10 10 0 6 0 24 24 0 40 
33 0 0 53 5 42 5 53 0 0 0 
33 0 4 0 0 0 0 0 4 0 0 
0 0 22 0 115 116 117 0 23 0 0 
0 0 22 0 118 119 120 0 23 0 0 
0 0 22 0 121 122 123 0 23 0 0 
0 0 0 0 0 6 0 0 0 0 0 
52 52 0 0 43 0 0 0 0 0 52 
