3 0 0 0 0 0 0 0 0 0 0 
0 37 60 0 0 0 4 0 0 43 25 
0 0 0 0 0 0 0 0 0 0 0 
13 64 65 66 0 0 0 69 44 0 0 
0 0 0 0 5 0 0 0 0 0 4 
10 0 0 23 0 0 0 0 0 52 40 
0 0 0 0 0 0 37 0 0 0 52 
96 0 0 29 0 4 0 0 0 0 0 
0 0 0 0 0 0 4 40 0 24 18 
0 0 10 0 0 0 0 0 0 0 0 
0 0 10 0 5 33 0 0 4 43 0 
