0 29 0 0 10 24 0 0 4 0 0 
46 0 0 0 0 0 0 51 0 48 16 
0 0 0 0 0 0 0 51 0 10 63 
46 0 48 0 0 38 4 0 0 0 0 
0 0 0 0 0 0 0 16 5 16 0 
0 0 5 0 50 0 0 0 0 24 0 
0 13 34 4 0 0 0 4 0 50 0 
0 0 5 0 50 0 4 55 0 0 0 
23 16 0 0 0 0 0 0 0 0 0 
0 38 0 0 0 0 38 49 0 0 0 
0 22 0 0 0 3 0 48 0 0 0 
