0 0 0 0 0 0 0 100 102 100 0 
103 0 0 100 0 0 0 0 0 0 5 
104 0 0 4 0 10 10 100 102 100 0 
103 0 0 4 0 0 0 0 0 0 0 
0 0 0 4 0 29 0 0 23 0 0 
0 0 0 4 0 103 0 0 0 0 100 
0 0 0 4 0 13 69 4 4 4 54 
0 0 0 4 0 103 0 0 0 0 100 
0 0 0 4 0 0 0 0 22 0 0 
28 0 0 0 0 0 0 0 0 0 0 
25 22 0 3 0 10 10 102 104 102 0 
