0 0 0 0 3 0 0 0 0 0 3 
0 0 0 0 38 0 0 0 10 9 8 
0 0 0 0 27 0 0 0 0 0 0 
0 0 0 0 46 0 0 62 49 61 0 
0 0 0 0 51 0 0 0 0 0 24 
0 0 0 49 16 0 0 23 16 24 0 
0 0 0 4 0 0 0 0 0 0 0 
34 34 0 30 10 0 0 22 0 13 34 
34 0 0 0 26 0 0 0 0 0 38 
55 55 0 26 26 0 0 0 67 62 61 
0 0 0 0 0 0 0 0 0 0 0 
