0 48 0 36 0 0 23 36 23 36 0 
0 0 0 0 0 0 0 0 0 0 4 
0 0 54 0 24 0 0 4 0 24 0 
36 4 0 0 24 29 0 4 0 24 100 
0 0 0 0 0 0 0 0 0 0 3 
10 25 0 100 0 0 69 36 0 0 0 
4 0 0 0 0 5 0 0 0 5 39 
4 0 10 0 10 8 10 0 40 0 22 
32 0 10 0 24 13 24 0 0 0 0 
32 0 0 0 0 0 0 0 0 0 0 
18 0 0 0 38 38 0 0 3 0 79 
