00 00 00 00 00 00 00 00 00 00 00
00 03 00 15 00 00 00 00 47 05 00
00 00 00 00 00 14 00 00 00 00 00
00 15 00 00 14 15 00 00 00 00 00
00 00 00 00 00 00 00 00 00 00 00
03 00 00 15 00 00 05 00 00 00 00
00 00 00 00 00 00 00 00 00 04 00
00 00 19 20 21 00 00 00 00 17 00
00 03 12 14 00 00 14 00 00 00 00
00 00 25 00 00 00 00 13 00 13 00
00 00 00 00 00 00 00 00 00 00 00