1 94 2 2 94 1 95 95 95 95 95 
1 94 2 2 94 94 94 94 94 94 95 
1 94 2 2 2 2 2 2 2 94 95 
1 94 2 2 2 2 2 2 2 94 95 
1 94 2 2 2 2 2 2 2 2 95 
1 1 1 1 1 1 1 1 1 1 1 
1 94 2 2 2 2 2 2 2 2 2 
1 94 2 2 2 2 2 2 2 2 2 
1 94 2 2 2 2 2 2 2 2 2 
1 94 94 94 94 94 94 2 2 2 2 
1 94 94 94 94 1 94 2 2 2 2 
