62 62 61 61 0 8 0 24 24 24 24 
62 62 61 61 0 30 0 24 24 24 24 
0 0 0 0 0 63 0 0 0 0 0 
0 0 0 0 0 0 0 0 0 0 0 
0 6 0 0 0 0 0 0 0 6 0 
0 0 0 0 0 0 0 0 0 0 0 
0 0 0 6 0 0 0 6 0 0 0 
0 0 0 0 0 0 0 0 0 0 0 
0 0 0 0 0 0 0 0 0 0 0 
23 23 23 23 0 0 0 22 22 22 22 
23 23 23 23 0 0 0 22 22 22 22 
