00 61 62 24 00 03 00 18 00 10 09
00 15 26 15 00 14 00 00 00 00 00
00 00 00 00 00 27 00 00 00 00 00
00 00 27 00 00 14 00 00 00 00 24
00 00 00 00 00 00 00 00 15 00 00
00 00 47 17 00 13 00 00 00 27 04
00 00 04 00 00 00 00 00 05 00 04
00 00 00 00 00 00 00 00 27 00 00
00 22 08 23 00 00 00 00 17 17 17
00 00 30 00 00 00 00 00 00 00 00
00 00 00 00 00 29 00 00 00 24 10