0 16 49 0 0 0 50 0 0 24 25 
0 0 0 0 0 0 0 5 0 26 26 
0 0 25 16 0 0 0 0 0 0 0 
26 0 9 16 0 38 5 0 0 0 0 
23 0 16 0 0 0 0 0 4 38 16 
0 0 0 0 0 0 0 0 0 18 24 
0 3 16 0 0 0 0 0 0 0 0 
0 0 0 4 0 0 0 51 0 0 0 
61 0 0 49 0 0 0 0 0 0 0 
62 0 50 0 0 50 0 13 0 38 0 
9 51 38 0 0 0 16 0 38 0 0 
