13 0 0 4 0 104 0 104 0 105 0 
0 0 28 0 0 0 28 0 28 0 0 
0 0 30 0 0 0 0 0 0 0 0 
0 0 0 0 0 0 0 0 0 0 0 
0 0 76 0 0 0 0 0 0 0 0 
0 0 5 0 0 0 28 0 28 0 0 
0 0 102 0 0 105 0 103 0 103 0 
0 0 0 0 0 0 0 0 0 0 0 
0 54 54 54 10 9 8 54 54 54 0 
0 0 0 0 0 0 0 0 0 0 0 
0 0 102 102 24 24 24 102 102 0 3 
