0 4 0 0 44 13 44 5 56 0 56 
37 0 13 0 0 44 0 0 0 60 0 
44 0 0 0 23 0 0 0 0 0 0 
37 0 22 0 0 0 0 0 0 0 0 
0 0 37 0 0 0 0 0 23 23 0 
0 0 0 0 56 0 0 0 0 0 0 
0 4 0 0 4 0 24 10 10 0 0 
0 4 0 24 24 4 60 0 0 0 0 
0 0 0 24 24 0 0 0 0 0 4 
0 0 0 0 0 0 0 0 0 0 0 
9 56 0 56 44 56 0 0 4 0 3 
