22 0 22 103 102 0 105 103 23 0 72 
54 0 0 102 0 0 0 105 0 0 72 
23 0 0 0 0 0 0 0 29 0 72 
4 0 0 0 0 0 0 0 0 0 72 
0 105 0 0 0 0 0 0 0 0 101 
0 104 0 104 0 0 0 0 0 0 0 
0 105 0 0 0 3 0 0 0 54 0 
4 0 0 0 0 0 0 0 0 0 4 
22 0 24 104 0 0 0 105 9 0 54 
28 0 0 0 0 0 0 103 0 0 23 
22 0 24 104 0 0 0 105 10 0 13 
