1 0 1 1 77 1 77 1 1 0 1 
1 1 1 1 77 1 1 1 1 1 1 
1 0 1 1 1 1 77 1 1 0 1 
77 77 77 77 77 1 77 77 77 77 77 
1 1 1 1 1 1 1 1 1 1 1 
1 77 77 77 77 77 77 77 77 77 1 
1 1 1 1 1 1 1 1 1 1 1 
1 77 1 77 77 1 77 77 1 77 1 
1 1 1 77 77 1 77 77 1 1 1 
1 1 1 77 1 1 1 77 77 1 77 
1 1 1 77 1 1 1 77 77 1 77 
