00 00 00 00 00 00 00 00 00 00 00
00 13 00 00 00 00 27 14 00 00 00
00 00 00 04 00 00 14 47 00 00 00
00 25 00 17 00 00 18 63 00 00 00
00 00 00 00 00 00 00 00 00 00 00
13 00 47 00 00 03 14 27 00 47 00
00 00 00 00 00 00 00 00 00 00 00
00 00 09 00 00 00 00 00 00 10 00
00 13 00 00 00 00 00 00 05 17 00
00 00 12 14 12 00 00 00 00 09 00
00 00 00 00 00 00 00 00 00 00 00