3 0 0 8 0 13 0 13 0 45 50 
0 22 56 0 0 0 0 0 0 0 45 
0 0 0 0 0 0 0 23 3 0 0 
0 0 0 56 0 50 0 22 0 0 0 
0 38 0 0 0 48 0 0 5 0 0 
50 34 50 5 0 50 0 0 0 0 0 
0 0 0 59 0 0 0 0 0 0 0 
0 45 0 0 0 0 0 45 0 0 4 
0 0 0 0 0 0 5 38 45 0 0 
75 0 16 0 0 0 0 0 0 0 59 
59 59 0 48 0 5 38 48 38 0 0 
