0 0 0 0 0 33 0 0 0 0 0 
44 0 0 0 0 0 0 0 0 24 0 
0 0 0 0 52 24 0 25 0 0 0 
3 0 0 0 52 24 0 22 23 0 4 
0 0 63 0 0 0 0 43 40 0 0 
0 0 0 0 10 10 0 0 5 0 0 
0 0 0 4 44 43 0 0 0 0 0 
4 0 0 0 0 0 3 0 33 4 0 
4 0 0 0 0 0 0 0 33 0 0 
0 0 44 0 0 37 0 0 0 0 0 
0 0 44 0 0 37 0 0 0 0 29 
