00 00 00 00 00 00 00 00 00 00 00
00 00 12 00 00 13 00 03 00 00 00
00 00 14 00 00 00 00 00 15 00 00
00 00 00 00 00 00 00 12 14 12 00
00 15 00 00 00 00 15 00 00 00 00
00 00 00 00 00 00 00 00 00 00 00
00 00 05 00 00 00 04 00 00 17 00
00 12 00 12 00 00 00 00 00 04 00
00 00 16 00 00 00 00 00 00 00 00
00 00 10 00 00 12 00 08 10 10 00
00 00 00 00 00 00 00 00 00 00 00