3 0 10 10 10 0 24 24 24 0 0 
0 0 0 0 0 0 0 0 0 0 24 
0 0 0 0 44 0 44 0 0 23 0 
0 0 24 0 0 0 0 0 22 0 0 
0 0 0 0 0 59 0 4 0 0 0 
0 0 0 0 16 4 45 44 0 0 0 
59 0 0 0 0 0 0 4 0 0 0 
0 0 24 0 0 0 0 0 0 0 0 
0 0 0 0 0 0 0 10 10 10 0 
0 0 45 0 0 5 0 0 0 0 0 
0 0 0 0 56 0 56 0 0 59 13 
