0 10 8 0 0 24 0 13 0 0 0 
102 0 10 0 0 0 0 100 0 0 32 
3 100 0 0 0 0 0 100 0 9 3 
0 0 102 0 39 0 0 39 0 25 32 
0 0 0 0 100 0 0 0 0 0 0 
24 0 0 0 39 0 100 0 0 24 0 
0 0 0 0 0 0 0 100 0 0 0 
0 0 100 102 69 0 0 0 0 0 0 
3 0 0 100 0 0 36 36 0 0 3 
23 0 0 0 22 0 36 0 0 0 0 
22 0 0 0 23 0 0 29 0 0 0 
