0 0 16 38 16 0 0 0 0 50 0 
0 0 0 0 0 0 0 0 0 16 38 
0 0 22 24 50 69 0 10 10 0 5 
23 0 0 0 0 50 0 51 51 0 16 
0 0 0 0 0 67 0 0 0 0 0 
0 0 0 0 55 55 0 0 0 0 49 
16 0 4 0 0 0 0 0 0 0 6 
0 0 0 34 59 70 0 71 72 59 59 
0 0 0 0 0 0 0 0 0 59 59 
0 0 46 26 0 13 0 3 0 9 8 
0 0 46 0 0 0 0 0 0 0 0 
